ward,precinct,total,Michael Cabonargi,Michael Cabonargi Percent,Samantha Steele,Samantha Steele Percent,precinct_id
1,1,170,36,21.18,134,78.82,01001
1,2,131,33,25.19,98,74.81,01002
1,3,181,59,32.6,122,67.4,01003
1,4,146,41,28.08,105,71.92,01004
1,5,129,42,32.56,87,67.44,01005
1,6,134,37,27.61,97,72.39,01006
1,7,129,43,33.33,86,66.67,01007
1,8,140,46,32.86,94,67.14,01008
1,9,111,32,28.83,79,71.17,01009
1,10,169,55,32.54,114,67.46,01010
1,11,171,49,28.65,122,71.35,01011
1,12,180,36,20.0,144,80.0,01012
1,13,81,26,32.1,55,67.9,01013
1,14,162,53,32.72,109,67.28,01014
1,15,130,42,32.31,88,67.69,01015
1,16,196,66,33.67,130,66.33,01016
1,17,135,35,25.93,100,74.07,01017
1,18,159,29,18.24,130,81.76,01018
1,19,236,57,24.15,179,75.85,01019
1,20,124,30,24.19,94,75.81,01020
1,21,182,52,28.57,130,71.43,01021
1,22,111,26,23.42,85,76.58,01022
1,23,235,69,29.36,166,70.64,01023
1,24,181,53,29.28,128,70.72,01024
1,25,148,46,31.08,102,68.92,01025
1,27,178,55,30.9,123,69.1,01027
1,28,28,8,28.57,20,71.43,01028
1,29,205,58,28.29,147,71.71,01029
1,30,193,56,29.02,137,70.98,01030
1,31,125,37,29.6,88,70.4,01031
1,32,147,41,27.89,106,72.11,01032
1,33,177,55,31.07,122,68.93,01033
1,34,153,40,26.14,113,73.86,01034
1,35,158,50,31.65,108,68.35,01035
1,36,181,59,32.6,122,67.4,01036
1,37,161,32,19.88,129,80.12,01037
1,38,140,39,27.86,101,72.14,01038
1,39,127,52,40.94,75,59.06,01039
1,40,127,52,40.94,75,59.06,01040
1,41,85,31,36.47,54,63.53,01041
1,42,45,13,28.89,32,71.11,01042
1,43,122,25,20.49,97,79.51,01043
1,44,138,42,30.43,96,69.57,01044
2,1,139,37,26.62,102,73.38,02001
2,2,128,77,60.16,51,39.84,02002
2,3,177,57,32.2,120,67.8,02003
2,4,159,51,32.08,108,67.92,02004
2,5,161,58,36.02,103,63.98,02005
2,6,130,40,30.77,90,69.23,02006
2,7,107,32,29.91,75,70.09,02007
2,8,140,55,39.29,85,60.71,02008
2,9,143,51,35.66,92,64.34,02009
2,10,34,25,73.53,9,26.47,02010
2,11,177,109,61.58,68,38.42,02011
2,12,112,47,41.96,65,58.04,02012
2,13,165,92,55.76,73,44.24,02013
2,14,165,65,39.39,100,60.61,02014
2,15,127,49,38.58,78,61.42,02015
2,16,159,58,36.48,101,63.52,02016
2,17,223,63,28.25,160,71.75,02017
2,18,133,58,43.61,75,56.39,02018
2,19,109,64,58.72,45,41.28,02019
2,20,128,58,45.31,70,54.69,02020
2,21,163,46,28.22,117,71.78,02021
2,22,163,87,53.37,76,46.63,02022
2,23,120,74,61.67,46,38.33,02023
2,24,126,49,38.89,77,61.11,02024
2,25,175,72,41.14,103,58.86,02025
2,26,108,41,37.96,67,62.04,02026
2,27,101,48,47.52,53,52.48,02027
2,28,134,50,37.31,84,62.69,02028
2,29,127,64,50.39,63,49.61,02029
2,30,119,59,49.58,60,50.42,02030
2,31,187,117,62.57,70,37.43,02031
2,32,76,41,53.95,35,46.05,02032
2,33,188,95,50.53,93,49.47,02033
2,34,140,90,64.29,50,35.71,02034
2,35,162,54,33.33,108,66.67,02035
2,36,135,51,37.78,84,62.22,02036
2,37,168,97,57.74,71,42.26,02037
2,38,123,65,52.85,58,47.15,02038
2,39,71,23,32.39,48,67.61,02039
2,40,149,51,34.23,98,65.77,02040
2,41,119,51,42.86,68,57.14,02041
2,42,117,55,47.01,62,52.99,02042
2,43,139,73,52.52,66,47.48,02043
2,44,148,80,54.05,68,45.95,02044
2,45,89,50,56.18,39,43.82,02045
2,46,78,30,38.46,48,61.54,02046
21,42,0,0,0.0,0,0.0,21042
25,16,84,38,45.24,46,54.76,25016
25,31,27,15,55.56,12,44.44,25031
26,1,112,32,28.57,80,71.43,26001
26,3,133,38,28.57,95,71.43,26003
26,7,97,19,19.59,78,80.41,26007
26,17,115,47,40.87,68,59.13,26017
26,20,109,38,34.86,71,65.14,26020
26,25,78,20,25.64,58,74.36,26025
26,26,73,15,20.55,58,79.45,26026
26,28,150,43,28.67,107,71.33,26028
26,30,106,22,20.75,84,79.25,26030
26,32,104,39,37.5,65,62.5,26032
26,34,131,35,26.72,96,73.28,26034
26,35,79,27,34.18,52,65.82,26035
26,37,112,33,29.46,79,70.54,26037
26,39,126,28,22.22,98,77.78,26039
26,48,122,30,24.59,92,75.41,26048
27,1,187,81,43.32,106,56.68,27001
27,6,118,49,41.53,69,58.47,27006
27,7,147,42,28.57,105,71.43,27007
27,9,50,19,38.0,31,62.0,27009
27,11,93,43,46.24,50,53.76,27011
27,12,77,37,48.05,40,51.95,27012
27,13,191,82,42.93,109,57.07,27013
27,16,80,28,35.0,52,65.0,27016
27,20,43,10,23.26,33,76.74,27020
27,21,127,50,39.37,77,60.63,27021
27,27,5,3,60.0,2,40.0,27027
27,28,154,52,33.77,102,66.23,27028
27,33,17,6,35.29,11,64.71,27033
27,35,142,42,29.58,100,70.42,27035
27,36,14,9,64.29,5,35.71,27036
27,37,130,41,31.54,89,68.46,27037
27,38,206,76,36.89,130,63.11,27038
27,40,106,37,34.91,69,65.09,27040
27,42,95,27,28.42,68,71.58,27042
27,43,6,2,33.33,4,66.67,27043
27,45,94,32,34.04,62,65.96,27045
27,46,87,42,48.28,45,51.72,27046
27,47,100,28,28.0,72,72.0,27047
27,48,168,58,34.52,110,65.48,27048
29,29,121,67,55.37,54,44.63,29029
29,31,83,52,62.65,31,37.35,29031
29,32,102,47,46.08,55,53.92,29032
29,39,84,42,50.0,42,50.0,29039
30,1,160,60,37.5,100,62.5,30001
30,2,96,49,51.04,47,48.96,30002
30,3,131,50,38.17,81,61.83,30003
30,4,102,41,40.2,61,59.8,30004
30,7,135,44,32.59,91,67.41,30007
30,8,177,38,21.47,139,78.53,30008
30,9,89,43,48.31,46,51.69,30009
30,15,176,72,40.91,104,59.09,30015
30,17,110,51,46.36,59,53.64,30017
30,20,132,49,37.12,83,62.88,30020
30,21,82,32,39.02,50,60.98,30021
30,23,129,35,27.13,94,72.87,30023
30,26,74,30,40.54,44,59.46,30026
30,27,78,31,39.74,47,60.26,30027
30,28,166,55,33.13,111,66.87,30028
30,31,55,26,47.27,29,52.73,30031
30,32,126,38,30.16,88,69.84,30032
31,6,52,17,32.69,35,67.31,31006
31,8,54,20,37.04,34,62.96,31008
31,9,58,35,60.34,23,39.66,31009
31,11,61,26,42.62,35,57.38,31011
31,12,72,32,44.44,40,55.56,31012
31,14,67,33,49.25,34,50.75,31014
31,23,82,33,40.24,49,59.76,31023
31,25,55,29,52.73,26,47.27,31025
31,31,50,25,50.0,25,50.0,31031
31,33,57,27,47.37,30,52.63,31033
31,34,86,36,41.86,50,58.14,31034
31,35,63,22,34.92,41,65.08,31035
31,36,67,22,32.84,45,67.16,31036
32,1,168,50,29.76,118,70.24,32001
32,2,134,51,38.06,83,61.94,32002
32,3,189,51,26.98,138,73.02,32003
32,4,149,70,46.98,79,53.02,32004
32,5,152,51,33.55,101,66.45,32005
32,6,175,55,31.43,120,68.57,32006
32,7,156,48,30.77,108,69.23,32007
32,8,155,58,37.42,97,62.58,32008
32,9,142,45,31.69,97,68.31,32009
32,10,154,76,49.35,78,50.65,32010
32,11,172,46,26.74,126,73.26,32011
32,12,146,40,27.4,106,72.6,32012
32,13,142,50,35.21,92,64.79,32013
32,14,201,57,28.36,144,71.64,32014
32,15,151,64,42.38,87,57.62,32015
32,16,156,63,40.38,93,59.62,32016
32,17,179,46,25.7,133,74.3,32017
32,18,131,46,35.11,85,64.89,32018
32,19,145,55,37.93,90,62.07,32019
32,20,177,46,25.99,131,74.01,32020
32,21,183,72,39.34,111,60.66,32021
32,22,259,58,22.39,201,77.61,32022
32,23,144,58,40.28,86,59.72,32023
32,24,115,52,45.22,63,54.78,32024
32,25,163,66,40.49,97,59.51,32025
32,26,220,78,35.45,142,64.55,32026
32,27,110,44,40.0,66,60.0,32027
32,28,198,46,23.23,152,76.77,32028
32,29,146,51,34.93,95,65.07,32029
32,30,117,55,47.01,62,52.99,32030
32,31,132,51,38.64,81,61.36,32031
32,32,178,62,34.83,116,65.17,32032
32,33,150,61,40.67,89,59.33,32033
32,34,155,45,29.03,110,70.97,32034
32,35,142,62,43.66,80,56.34,32035
32,36,134,49,36.57,85,63.43,32036
32,37,161,57,35.4,104,64.6,32037
32,38,143,55,38.46,88,61.54,32038
32,39,146,67,45.89,79,54.11,32039
32,40,146,60,41.1,86,58.9,32040
32,41,157,55,35.03,102,64.97,32041
32,42,126,57,45.24,69,54.76,32042
32,43,203,42,20.69,161,79.31,32043
33,1,202,66,32.67,136,67.33,33001
33,2,224,76,33.93,148,66.07,33002
33,3,259,84,32.43,175,67.57,33003
33,4,229,80,34.93,149,65.07,33004
33,5,138,50,36.23,88,63.77,33005
33,6,139,49,35.25,90,64.75,33006
33,7,200,65,32.5,135,67.5,33007
33,8,287,121,42.16,166,57.84,33008
33,9,203,77,37.93,126,62.07,33009
33,10,140,62,44.29,78,55.71,33010
33,11,207,78,37.68,129,62.32,33011
33,12,162,68,41.98,94,58.02,33012
33,13,172,63,36.63,109,63.37,33013
33,14,92,38,41.3,54,58.7,33014
33,15,210,73,34.76,137,65.24,33015
33,16,230,100,43.48,130,56.52,33016
33,17,185,56,30.27,129,69.73,33017
33,18,230,73,31.74,157,68.26,33018
33,19,174,55,31.61,119,68.39,33019
33,20,264,90,34.09,174,65.91,33020
33,21,200,75,37.5,125,62.5,33021
33,22,169,88,52.07,81,47.93,33022
33,23,227,76,33.48,151,66.52,33023
33,24,301,128,42.52,173,57.48,33024
33,25,212,88,41.51,124,58.49,33025
33,26,138,38,27.54,100,72.46,33026
33,27,171,50,29.24,121,70.76,33027
33,28,164,41,25.0,123,75.0,33028
35,1,180,47,26.11,133,73.89,35001
35,2,198,57,28.79,141,71.21,35002
35,4,164,66,40.24,98,59.76,35004
35,5,139,44,31.65,95,68.35,35005
35,6,143,38,26.57,105,73.43,35006
35,7,186,47,25.27,139,74.73,35007
35,8,161,42,26.09,119,73.91,35008
35,9,114,42,36.84,72,63.16,35009
35,10,191,37,19.37,154,80.63,35010
35,11,185,48,25.95,137,74.05,35011
35,17,181,47,25.97,134,74.03,35017
35,20,115,37,32.17,78,67.83,35020
35,22,173,47,27.17,126,72.83,35022
35,23,160,61,38.13,99,61.88,35023
35,24,126,35,27.78,91,72.22,35024
35,25,146,27,18.49,119,81.51,35025
35,26,109,39,35.78,70,64.22,35026
35,27,135,44,32.59,91,67.41,35027
35,29,106,30,28.3,76,71.7,35029
35,30,112,37,33.04,75,66.96,35030
35,31,173,53,30.64,120,69.36,35031
36,7,136,71,52.21,65,47.79,36007
36,10,96,45,46.88,51,53.13,36010
36,14,127,53,41.73,74,58.27,36014
36,15,117,65,55.56,52,44.44,36015
36,16,113,48,42.48,65,57.52,36016
36,17,142,73,51.41,69,48.59,36017
36,18,135,63,46.67,72,53.33,36018
36,19,114,43,37.72,71,62.28,36019
36,20,113,48,42.48,65,57.52,36020
36,24,102,52,50.98,50,49.02,36024
36,26,81,42,51.85,39,48.15,36026
36,28,83,38,45.78,45,54.22,36028
36,29,114,64,56.14,50,43.86,36029
36,30,102,57,55.88,45,44.12,36030
38,1,126,57,45.24,69,54.76,38001
38,2,117,81,69.23,36,30.77,38002
38,3,94,52,55.32,42,44.68,38003
38,4,107,67,62.62,40,37.38,38004
38,5,95,69,72.63,26,27.37,38005
38,6,82,46,56.1,36,43.9,38006
38,7,108,67,62.04,41,37.96,38007
38,8,89,47,52.81,42,47.19,38008
38,9,139,67,48.2,72,51.8,38009
38,10,93,41,44.09,52,55.91,38010
38,11,105,48,45.71,57,54.29,38011
38,12,104,72,69.23,32,30.77,38012
38,13,117,72,61.54,45,38.46,38013
38,14,136,73,53.68,63,46.32,38014
38,15,111,57,51.35,54,48.65,38015
38,16,98,59,60.2,39,39.8,38016
38,17,123,77,62.6,46,37.4,38017
38,18,123,59,47.97,64,52.03,38018
38,19,150,99,66.0,51,34.0,38019
38,20,101,58,57.43,43,42.57,38020
38,21,123,73,59.35,50,40.65,38021
38,22,134,76,56.72,58,43.28,38022
38,23,135,65,48.15,70,51.85,38023
38,24,103,62,60.19,41,39.81,38024
38,25,110,49,44.55,61,55.45,38025
38,26,126,73,57.94,53,42.06,38026
38,27,98,64,65.31,34,34.69,38027
38,28,102,59,57.84,43,42.16,38028
38,29,122,66,54.1,56,45.9,38029
38,30,89,52,58.43,37,41.57,38030
38,31,172,88,51.16,84,48.84,38031
38,32,111,59,53.15,52,46.85,38032
38,33,94,35,37.23,59,62.77,38033
38,34,131,61,46.56,70,53.44,38034
38,35,118,45,38.14,73,61.86,38035
38,36,113,64,56.64,49,43.36,38036
38,37,124,61,49.19,63,50.81,38037
38,38,113,57,50.44,56,49.56,38038
38,39,151,61,40.4,90,59.6,38039
38,40,149,74,49.66,75,50.34,38040
38,41,176,99,56.25,77,43.75,38041
39,1,127,76,59.84,51,40.16,39001
39,2,126,61,48.41,65,51.59,39002
39,3,184,67,36.41,117,63.59,39003
39,4,148,82,55.41,66,44.59,39004
39,5,168,77,45.83,91,54.17,39005
39,6,131,52,39.69,79,60.31,39006
39,7,143,72,50.35,71,49.65,39007
39,8,175,67,38.29,108,61.71,39008
39,9,115,49,42.61,66,57.39,39009
39,10,93,31,33.33,62,66.67,39010
39,11,145,61,42.07,84,57.93,39011
39,12,178,81,45.51,97,54.49,39012
39,13,110,36,32.73,74,67.27,39013
39,14,157,65,41.4,92,58.6,39014
39,15,149,91,61.07,58,38.93,39015
39,16,87,41,47.13,46,52.87,39016
39,17,209,99,47.37,110,52.63,39017
39,18,156,70,44.87,86,55.13,39018
39,19,162,62,38.27,100,61.73,39019
39,20,170,88,51.76,82,48.24,39020
39,21,126,56,44.44,70,55.56,39021
39,22,89,35,39.33,54,60.67,39022
39,23,142,77,54.23,65,45.77,39023
39,24,185,98,52.97,87,47.03,39024
39,25,87,41,47.13,46,52.87,39025
39,26,111,55,49.55,56,50.45,39026
39,27,37,20,54.05,17,45.95,39027
39,28,222,94,42.34,128,57.66,39028
39,29,70,19,27.14,51,72.86,39029
39,30,163,62,38.04,101,61.96,39030
39,31,100,51,51.0,49,49.0,39031
39,32,134,67,50.0,67,50.0,39032
39,33,136,48,35.29,88,64.71,39033
39,34,143,53,37.06,90,62.94,39034
39,35,164,80,48.78,84,51.22,39035
39,36,48,16,33.33,32,66.67,39036
39,37,170,98,57.65,72,42.35,39037
39,38,129,87,67.44,42,32.56,39038
39,39,93,46,49.46,47,50.54,39039
39,40,131,73,55.73,58,44.27,39040
39,41,168,79,47.02,89,52.98,39041
39,42,180,119,66.11,61,33.89,39042
39,43,141,79,56.03,62,43.97,39043
39,44,107,56,52.34,51,47.66,39044
39,45,150,84,56.0,66,44.0,39045
40,1,120,49,40.83,71,59.17,40001
40,2,159,78,49.06,81,50.94,40002
40,3,246,86,34.96,160,65.04,40003
40,4,95,52,54.74,43,45.26,40004
40,5,209,93,44.5,116,55.5,40005
40,6,231,85,36.8,146,63.2,40006
40,7,223,100,44.84,123,55.16,40007
40,8,317,126,39.75,191,60.25,40008
40,9,114,56,49.12,58,50.88,40009
40,10,120,62,51.67,58,48.33,40010
40,11,219,105,47.95,114,52.05,40011
40,12,174,68,39.08,106,60.92,40012
40,13,317,123,38.8,194,61.2,40013
40,14,138,52,37.68,86,62.32,40014
40,15,132,63,47.73,69,52.27,40015
40,16,299,122,40.8,177,59.2,40016
40,17,182,85,46.7,97,53.3,40017
40,18,104,57,54.81,47,45.19,40018
40,19,189,86,45.5,103,54.5,40019
40,20,140,50,35.71,90,64.29,40020
40,21,261,131,50.19,130,49.81,40021
40,22,249,131,52.61,118,47.39,40022
40,23,310,113,36.45,197,63.55,40023
40,24,123,67,54.47,56,45.53,40024
40,25,268,95,35.45,173,64.55,40025
40,26,236,102,43.22,134,56.78,40026
40,27,219,101,46.12,118,53.88,40027
40,28,200,85,42.5,115,57.5,40028
40,29,185,109,58.92,76,41.08,40029
40,30,165,94,56.97,71,43.03,40030
40,31,274,99,36.13,175,63.87,40031
40,32,231,114,49.35,117,50.65,40032
40,33,252,124,49.21,128,50.79,40033
40,34,137,70,51.09,67,48.91,40034
40,35,67,42,62.69,25,37.31,40035
40,36,158,90,56.96,68,43.04,40036
40,37,167,93,55.69,74,44.31,40037
40,38,250,102,40.8,148,59.2,40038
40,39,33,17,51.52,16,48.48,40039
41,1,110,59,53.64,51,46.36,41001
41,2,121,70,57.85,51,42.15,41002
41,3,128,67,52.34,61,47.66,41003
41,4,133,82,61.65,51,38.35,41004
41,5,131,79,60.31,52,39.69,41005
41,6,195,121,62.05,74,37.95,41006
41,7,109,57,52.29,52,47.71,41007
41,8,117,67,57.26,50,42.74,41008
41,9,114,61,53.51,53,46.49,41009
41,10,169,112,66.27,57,33.73,41010
41,11,134,75,55.97,59,44.03,41011
41,12,108,66,61.11,42,38.89,41012
41,13,116,66,56.9,50,43.1,41013
41,14,191,115,60.21,76,39.79,41014
41,15,168,85,50.6,83,49.4,41015
41,16,103,63,61.17,40,38.83,41016
41,17,112,59,52.68,53,47.32,41017
41,18,101,62,61.39,39,38.61,41018
41,19,157,78,49.68,79,50.32,41019
41,20,69,36,52.17,33,47.83,41020
41,21,142,82,57.75,60,42.25,41021
41,22,164,90,54.88,74,45.12,41022
41,23,105,72,68.57,33,31.43,41023
41,24,103,55,53.4,48,46.6,41024
41,25,49,21,42.86,28,57.14,41025
41,26,118,71,60.17,47,39.83,41026
41,27,64,40,62.5,24,37.5,41027
41,28,79,33,41.77,46,58.23,41028
41,29,45,30,66.67,15,33.33,41029
41,30,126,56,44.44,70,55.56,41030
41,31,118,56,47.46,62,52.54,41031
41,32,116,62,53.45,54,46.55,41032
41,33,110,71,64.55,39,35.45,41033
41,34,96,59,61.46,37,38.54,41034
41,35,166,86,51.81,80,48.19,41035
41,36,118,69,58.47,49,41.53,41036
41,37,149,89,59.73,60,40.27,41037
41,38,114,60,52.63,54,47.37,41038
41,39,163,87,53.37,76,46.63,41039
41,40,150,104,69.33,46,30.67,41040
41,41,103,67,65.05,36,34.95,41041
41,42,110,68,61.82,42,38.18,41042
41,43,123,71,57.72,52,42.28,41043
41,44,121,74,61.16,47,38.84,41044
41,45,122,63,51.64,59,48.36,41045
41,46,148,83,56.08,65,43.92,41046
41,47,168,83,49.4,85,50.6,41047
42,1,184,118,64.13,66,35.87,42001
42,3,33,10,30.3,23,69.7,42003
42,5,122,66,54.1,56,45.9,42005
42,9,77,33,42.86,44,57.14,42009
42,12,139,69,49.64,70,50.36,42012
42,14,139,55,39.57,84,60.43,42014
42,15,143,70,48.95,73,51.05,42015
42,17,147,64,43.54,83,56.46,42017
42,18,106,34,32.08,72,67.92,42018
42,19,88,53,60.23,35,39.77,42019
42,21,140,60,42.86,80,57.14,42021
42,23,127,50,39.37,77,60.63,42023
42,24,131,73,55.73,58,44.27,42024
42,34,137,81,59.12,56,40.88,42034
42,36,159,69,43.4,90,56.6,42036
42,37,89,41,46.07,48,53.93,42037
42,38,106,44,41.51,62,58.49,42038
42,39,103,43,41.75,60,58.25,42039
42,41,154,77,50.0,77,50.0,42041
43,1,80,36,45.0,44,55.0,43001
43,2,167,48,28.74,119,71.26,43002
43,3,140,72,51.43,68,48.57,43003
43,4,137,65,47.45,72,52.55,43004
43,5,149,69,46.31,80,53.69,43005
43,6,107,33,30.84,74,69.16,43006
43,7,123,39,31.71,84,68.29,43007
43,8,111,50,45.05,61,54.95,43008
43,9,161,59,36.65,102,63.35,43009
43,10,177,78,44.07,99,55.93,43010
43,11,98,51,52.04,47,47.96,43011
43,12,88,39,44.32,49,55.68,43012
43,13,172,67,38.95,105,61.05,43013
43,14,163,76,46.63,87,53.37,43014
43,15,140,71,50.71,69,49.29,43015
43,16,159,46,28.93,113,71.07,43016
43,17,123,55,44.72,68,55.28,43017
43,18,170,71,41.76,99,58.24,43018
43,19,153,72,47.06,81,52.94,43019
43,20,205,86,41.95,119,58.05,43020
43,21,134,58,43.28,76,56.72,43021
43,22,116,39,33.62,77,66.38,43022
43,23,98,44,44.9,54,55.1,43023
43,24,133,55,41.35,78,58.65,43024
43,25,179,90,50.28,89,49.72,43025
43,26,139,53,38.13,86,61.87,43026
43,27,150,73,48.67,77,51.33,43027
43,28,139,64,46.04,75,53.96,43028
43,29,184,70,38.04,114,61.96,43029
43,30,142,66,46.48,76,53.52,43030
43,31,152,60,39.47,92,60.53,43031
43,32,131,42,32.06,89,67.94,43032
43,33,191,86,45.03,105,54.97,43033
43,34,102,46,45.1,56,54.9,43034
43,35,177,96,54.24,81,45.76,43035
43,36,65,26,40.0,39,60.0,43036
43,37,130,33,25.38,97,74.62,43037
43,38,122,72,59.02,50,40.98,43038
43,39,85,29,34.12,56,65.88,43039
43,40,102,34,33.33,68,66.67,43040
43,41,160,61,38.13,99,61.88,43041
43,42,140,46,32.86,94,67.14,43042
43,43,167,91,54.49,76,45.51,43043
43,44,135,58,42.96,77,57.04,43044
43,45,111,50,45.05,61,54.95,43045
43,46,87,39,44.83,48,55.17,43046
44,1,277,115,41.52,162,58.48,44001
44,2,157,74,47.13,83,52.87,44002
44,3,152,108,71.05,44,28.95,44003
44,4,165,74,44.85,91,55.15,44004
44,5,169,70,41.42,99,58.58,44005
44,6,192,68,35.42,124,64.58,44006
44,7,143,68,47.55,75,52.45,44007
44,8,205,70,34.15,135,65.85,44008
44,9,131,43,32.82,88,67.18,44009
44,10,143,67,46.85,76,53.15,44010
44,11,158,49,31.01,109,68.99,44011
44,12,228,112,49.12,116,50.88,44012
44,13,127,57,44.88,70,55.12,44013
44,14,152,54,35.53,98,64.47,44014
44,15,179,70,39.11,109,60.89,44015
44,16,178,79,44.38,99,55.62,44016
44,17,248,104,41.94,144,58.06,44017
44,18,167,75,44.91,92,55.09,44018
44,19,243,101,41.56,142,58.44,44019
44,20,185,56,30.27,129,69.73,44020
44,21,183,66,36.07,117,63.93,44021
44,22,167,85,50.9,82,49.1,44022
44,23,149,62,41.61,87,58.39,44023
44,24,157,68,43.31,89,56.69,44024
44,25,202,62,30.69,140,69.31,44025
44,26,204,78,38.24,126,61.76,44026
44,27,184,68,36.96,116,63.04,44027
44,28,167,81,48.5,86,51.5,44028
44,29,181,68,37.57,113,62.43,44029
44,30,203,85,41.87,118,58.13,44030
44,31,112,30,26.79,82,73.21,44031
44,32,157,54,34.39,103,65.61,44032
44,33,190,66,34.74,124,65.26,44033
44,34,201,73,36.32,128,63.68,44034
44,35,215,109,50.7,106,49.3,44035
44,36,169,72,42.6,97,57.4,44036
44,37,238,98,41.18,140,58.82,44037
44,38,146,62,42.47,84,57.53,44038
44,39,173,69,39.88,104,60.12,44039
44,40,161,62,38.51,99,61.49,44040
44,41,212,75,35.38,137,64.62,44041
45,1,164,77,46.95,87,53.05,45001
45,2,189,70,37.04,119,62.96,45002
45,3,174,74,42.53,100,57.47,45003
45,4,202,87,43.07,115,56.93,45004
45,5,184,79,42.93,105,57.07,45005
45,6,252,110,43.65,142,56.35,45006
45,7,253,117,46.25,136,53.75,45007
45,8,151,72,47.68,79,52.32,45008
45,9,134,59,44.03,75,55.97,45009
45,10,152,68,44.74,84,55.26,45010
45,11,83,34,40.96,49,59.04,45011
45,12,128,58,45.31,70,54.69,45012
45,13,139,61,43.88,78,56.12,45013
45,14,210,87,41.43,123,58.57,45014
45,15,220,125,56.82,95,43.18,45015
45,16,148,68,45.95,80,54.05,45016
45,17,155,77,49.68,78,50.32,45017
45,18,153,82,53.59,71,46.41,45018
45,19,67,28,41.79,39,58.21,45019
45,20,84,43,51.19,41,48.81,45020
45,21,132,52,39.39,80,60.61,45021
45,22,94,48,51.06,46,48.94,45022
45,23,116,66,56.9,50,43.1,45023
45,24,81,42,51.85,39,48.15,45024
45,25,99,51,51.52,48,48.48,45025
45,26,73,45,61.64,28,38.36,45026
45,27,124,61,49.19,63,50.81,45027
45,28,102,42,41.18,60,58.82,45028
45,29,97,59,60.82,38,39.18,45029
45,30,115,45,39.13,70,60.87,45030
45,31,117,60,51.28,57,48.72,45031
45,32,117,48,41.03,69,58.97,45032
45,33,109,48,44.04,61,55.96,45033
45,34,138,59,42.75,79,57.25,45034
45,35,160,85,53.13,75,46.88,45035
45,36,168,83,49.4,85,50.6,45036
45,37,146,64,43.84,82,56.16,45037
45,38,118,61,51.69,57,48.31,45038
45,39,130,59,45.38,71,54.62,45039
45,40,120,58,48.33,62,51.67,45040
45,41,109,57,52.29,52,47.71,45041
45,42,145,79,54.48,66,45.52,45042
45,43,114,60,52.63,54,47.37,45043
45,44,149,81,54.36,68,45.64,45044
45,45,62,30,48.39,32,51.61,45045
45,46,81,51,62.96,30,37.04,45046
45,47,88,47,53.41,41,46.59,45047
45,48,87,48,55.17,39,44.83,45048
46,1,140,44,31.43,96,68.57,46001
46,2,207,63,30.43,144,69.57,46002
46,3,259,108,41.7,151,58.3,46003
46,4,223,82,36.77,141,63.23,46004
46,5,215,86,40.0,129,60.0,46005
46,6,187,68,36.36,119,63.64,46006
46,7,265,153,57.74,112,42.26,46007
46,8,139,51,36.69,88,63.31,46008
46,9,218,84,38.53,134,61.47,46009
46,10,255,89,34.9,166,65.1,46010
46,11,175,72,41.14,103,58.86,46011
46,12,241,79,32.78,162,67.22,46012
46,13,218,100,45.87,118,54.13,46013
46,14,143,70,48.95,73,51.05,46014
46,15,187,84,44.92,103,55.08,46015
46,16,270,86,31.85,184,68.15,46016
46,17,225,117,52.0,108,48.0,46017
46,18,202,75,37.13,127,62.87,46018
46,19,165,99,60.0,66,40.0,46019
46,20,175,60,34.29,115,65.71,46020
46,21,87,33,37.93,54,62.07,46021
46,22,116,37,31.9,79,68.1,46022
46,23,184,57,30.98,127,69.02,46023
46,24,302,129,42.72,173,57.28,46024
46,25,204,74,36.27,130,63.73,46025
46,26,237,84,35.44,153,64.56,46026
46,27,207,58,28.02,149,71.98,46027
46,28,179,93,51.96,86,48.04,46028
46,29,155,91,58.71,64,41.29,46029
46,30,180,66,36.67,114,63.33,46030
46,31,194,65,33.51,129,66.49,46031
46,32,81,27,33.33,54,66.67,46032
46,33,210,97,46.19,113,53.81,46033
46,34,235,96,40.85,139,59.15,46034
46,35,150,63,42.0,87,58.0,46035
46,36,221,101,45.7,120,54.3,46036
46,37,132,62,46.97,70,53.03,46037
46,38,177,62,35.03,115,64.97,46038
46,39,177,70,39.55,107,60.45,46039
46,40,204,85,41.67,119,58.33,46040
47,1,138,55,39.86,83,60.14,47001
47,2,176,71,40.34,105,59.66,47002
47,3,196,95,48.47,101,51.53,47003
47,4,219,91,41.55,128,58.45,47004
47,5,255,117,45.88,138,54.12,47005
47,6,216,79,36.57,137,63.43,47006
47,7,176,77,43.75,99,56.25,47007
47,8,214,102,47.66,112,52.34,47008
47,9,157,65,41.4,92,58.6,47009
47,10,292,95,32.53,197,67.47,47010
47,11,178,70,39.33,108,60.67,47011
47,12,214,86,40.19,128,59.81,47012
47,13,253,107,42.29,146,57.71,47013
47,14,198,105,53.03,93,46.97,47014
47,15,298,99,33.22,199,66.78,47015
47,16,194,88,45.36,106,54.64,47016
47,17,212,100,47.17,112,52.83,47017
47,18,192,79,41.15,113,58.85,47018
47,19,360,145,40.28,215,59.72,47019
47,20,226,90,39.82,136,60.18,47020
47,21,253,95,37.55,158,62.45,47021
47,22,275,149,54.18,126,45.82,47022
47,23,257,83,32.3,174,67.7,47023
47,24,240,111,46.25,129,53.75,47024
47,25,240,117,48.75,123,51.25,47025
47,26,284,102,35.92,182,64.08,47026
47,27,207,80,38.65,127,61.35,47027
47,28,207,90,43.48,117,56.52,47028
47,29,220,95,43.18,125,56.82,47029
47,30,269,125,46.47,144,53.53,47030
47,31,245,117,47.76,128,52.24,47031
47,32,313,143,45.69,170,54.31,47032
47,33,176,66,37.5,110,62.5,47033
47,34,228,97,42.54,131,57.46,47034
47,35,147,75,51.02,72,48.98,47035
47,36,271,106,39.11,165,60.89,47036
47,37,216,83,38.43,133,61.57,47037
47,38,241,97,40.25,144,59.75,47038
47,39,269,127,47.21,142,52.79,47039
47,40,190,87,45.79,103,54.21,47040
47,41,255,109,42.75,146,57.25,47041
47,42,217,80,36.87,137,63.13,47042
47,43,172,80,46.51,92,53.49,47043
47,44,178,73,41.01,105,58.99,47044
47,45,251,110,43.82,141,56.18,47045
47,46,98,43,43.88,55,56.12,47046
47,47,216,95,43.98,121,56.02,47047
47,48,23,8,34.78,15,65.22,47048
48,1,232,91,39.22,141,60.78,48001
48,2,93,58,62.37,35,37.63,48002
48,3,204,81,39.71,123,60.29,48003
48,4,243,113,46.5,130,53.5,48004
48,5,188,128,68.09,60,31.91,48005
48,6,203,71,34.98,132,65.02,48006
48,7,259,119,45.95,140,54.05,48007
48,8,124,73,58.87,51,41.13,48008
48,9,144,75,52.08,69,47.92,48009
48,10,333,119,35.74,214,64.26,48010
48,11,205,100,48.78,105,51.22,48011
48,12,256,102,39.84,154,60.16,48012
48,13,274,148,54.01,126,45.99,48013
48,14,102,55,53.92,47,46.08,48014
48,15,99,52,52.53,47,47.47,48015
48,16,210,74,35.24,136,64.76,48016
48,17,220,88,40.0,132,60.0,48017
48,18,137,60,43.8,77,56.2,48018
48,19,186,94,50.54,92,49.46,48019
48,20,254,102,40.16,152,59.84,48020
48,21,238,74,31.09,164,68.91,48021
48,22,217,123,56.68,94,43.32,48022
48,23,261,140,53.64,121,46.36,48023
48,24,184,82,44.57,102,55.43,48024
48,25,202,85,42.08,117,57.92,48025
48,26,88,38,43.18,50,56.82,48026
48,27,123,61,49.59,62,50.41,48027
48,28,213,76,35.68,137,64.32,48028
48,29,139,77,55.4,62,44.6,48029
48,30,201,96,47.76,105,52.24,48030
48,31,207,79,38.16,128,61.84,48031
48,32,179,69,38.55,110,61.45,48032
48,33,128,79,61.72,49,38.28,48033
48,34,177,76,42.94,101,57.06,48034
48,35,121,54,44.63,67,55.37,48035
48,36,149,94,63.09,55,36.91,48036
48,37,228,76,33.33,152,66.67,48037
48,38,251,142,56.57,109,43.43,48038
48,39,181,100,55.25,81,44.75,48039
48,40,186,78,41.94,108,58.06,48040
48,41,206,66,32.04,140,67.96,48041
48,42,268,92,34.33,176,65.67,48042
48,43,232,107,46.12,125,53.88,48043
48,44,268,114,42.54,154,57.46,48044
48,45,143,54,37.76,89,62.24,48045
48,46,151,91,60.26,60,39.74,48046
49,1,105,37,35.24,68,64.76,49001
49,2,127,50,39.37,77,60.63,49002
49,3,226,97,42.92,129,57.08,49003
49,4,236,84,35.59,152,64.41,49004
49,5,196,80,40.82,116,59.18,49005
49,6,162,72,44.44,90,55.56,49006
49,7,144,71,49.31,73,50.69,49007
49,8,147,74,50.34,73,49.66,49008
49,9,198,81,40.91,117,59.09,49009
49,10,197,83,42.13,114,57.87,49010
49,11,224,104,46.43,120,53.57,49011
49,12,208,88,42.31,120,57.69,49012
49,13,230,107,46.52,123,53.48,49013
49,14,126,53,42.06,73,57.94,49014
49,15,133,59,44.36,74,55.64,49015
49,16,184,91,49.46,93,50.54,49016
49,17,150,82,54.67,68,45.33,49017
49,18,241,94,39.0,147,61.0,49018
49,19,131,56,42.75,75,57.25,49019
49,20,288,101,35.07,187,64.93,49020
49,21,80,37,46.25,43,53.75,49021
49,22,195,99,50.77,96,49.23,49022
49,23,219,80,36.53,139,63.47,49023
49,24,116,40,34.48,76,65.52,49024
49,25,224,93,41.52,131,58.48,49025
49,26,199,66,33.17,133,66.83,49026
49,27,159,55,34.59,104,65.41,49027
49,28,273,87,31.87,186,68.13,49028
49,29,230,88,38.26,142,61.74,49029
49,30,184,79,42.93,105,57.07,49030
49,31,124,56,45.16,68,54.84,49031
49,32,184,69,37.5,115,62.5,49032
49,33,156,78,50.0,78,50.0,49033
50,1,128,77,60.16,51,39.84,50001
50,2,70,37,52.86,33,47.14,50002
50,3,128,70,54.69,58,45.31,50003
50,4,151,75,49.67,76,50.33,50004
50,5,95,66,69.47,29,30.53,50005
50,6,159,80,50.31,79,49.69,50006
50,7,205,110,53.66,95,46.34,50007
50,8,118,47,39.83,71,60.17,50008
50,9,119,63,52.94,56,47.06,50009
50,10,94,49,52.13,45,47.87,50010
50,11,70,40,57.14,30,42.86,50011
50,12,52,23,44.23,29,55.77,50012
50,13,119,49,41.18,70,58.82,50013
50,14,43,24,55.81,19,44.19,50014
50,15,219,104,47.49,115,52.51,50015
50,16,49,30,61.22,19,38.78,50016
50,17,93,51,54.84,42,45.16,50017
50,18,23,8,34.78,15,65.22,50018
50,19,75,36,48.0,39,52.0,50019
50,20,152,80,52.63,72,47.37,50020
50,21,125,67,53.6,58,46.4,50021
50,22,96,47,48.96,49,51.04,50022
50,23,58,34,58.62,24,41.38,50023
50,24,71,40,56.34,31,43.66,50024
50,25,94,48,51.06,46,48.94,50025
50,26,98,37,37.76,61,62.24,50026
50,27,40,19,47.5,21,52.5,50027
50,28,117,50,42.74,67,57.26,50028
50,29,64,28,43.75,36,56.25,50029
50,30,102,55,53.92,47,46.08,50030
50,31,124,50,40.32,74,59.68,50031
50,32,113,53,46.9,60,53.1,50032
50,33,101,55,54.46,46,45.54,50033
50,34,197,113,57.36,84,42.64,50034
50,35,183,110,60.11,73,39.89,50035
50,36,164,99,60.37,65,39.63,50036
50,37,118,55,46.61,63,53.39,50037
50,38,61,37,60.66,24,39.34,50038
50,39,62,27,43.55,35,56.45,50039
50,40,104,59,56.73,45,43.27,50040
